111111111111
100000000001
100000000001
100000000001
101000011111
101000010001
101000010001
101000010001
101000010001
100000010001
100000000001
111111111111