111111111111111111111111111111
101000000000000000000000000001
101111110111111101111111111101
101000010100000101000000000101
101010010101110100000000000101
101010010101010101000000000101
101010110100000101111111111101
100010000101111111000000000101
101111111101000001010101010101
101000000001001011110101010101
101010101100001010100000000001
101000000101101110111111111101
101101010100100000100010000101
101001010100111111110111010101
101001000100000000000101010101
101001010000111111111101011101
101001011111100001000000000001
101011001000000101011010101001
101011001011111101010010100101
101001001000000001011110101001
101111101011111101000000100101
101000101000000001111111101001
101010100011110101000000100101
100010001000000101011110101001
101111111101010101010010100101
101000101001010101011010101001
101010101011010101000010100101
100011101001010101111110101001
101000001101000100000000100001
111111111111111111111111111111